,0,1,2,3,4,5,6,7,8,9,10,11,12,13,14
A,1,1,1,1,0,1,1,0,0,0,1,0,1,0,0
C,0,0,0,0,0,0,0,0,0,0,0,0,0,0,0
D,0,0,0,0,0,1,0,0,0,1,0,1,0,0,0
E,0,1,0,0,0,0,0,0,0,0,0,0,0,0,0
F,0,1,0,0,1,0,0,0,0,0,0,0,0,2,0
G,0,1,0,0,1,0,1,0,0,0,2,0,1,3,1
H,0,0,1,0,0,0,0,0,0,0,1,0,0,0,0
I,0,0,0,0,0,1,0,0,0,1,0,0,0,0,0
K,1,0,1,0,0,0,0,0,1,0,0,1,0,0,0
L,0,0,1,1,1,0,1,0,0,0,0,1,0,0,1
M,0,0,0,0,0,0,0,0,0,0,0,0,0,0,0
N,1,0,1,1,0,0,0,0,0,0,0,0,1,1,1
P,0,1,0,1,1,1,0,0,5,0,0,1,1,0,0
Q,0,1,0,1,0,0,0,0,0,1,1,0,0,1,0
R,0,0,0,0,1,0,0,0,0,1,0,0,1,0,0
S,3,1,2,1,2,1,2,5,0,2,0,3,1,0,1
T,0,0,0,1,0,0,0,2,0,0,1,0,0,0,1
V,0,0,0,0,0,2,0,0,0,1,0,0,1,0,1
W,0,0,0,0,0,0,0,0,0,0,0,0,0,0,0
Y,1,0,0,0,0,0,2,0,1,0,1,0,0,0,1
