,0,1,2,3,4,5,6,7,8,9,10,11,12,13,14
A,0,1,0,0,0,1,1,0,1,4,1,0,1,3,2
C,0,0,0,0,0,0,0,0,0,1,0,0,1,0,0
D,0,1,1,0,0,1,2,0,0,1,0,1,0,2,0
E,0,0,0,2,2,0,0,0,0,0,0,0,0,0,1
F,0,0,0,1,1,0,0,0,2,0,1,0,0,0,1
G,0,0,3,0,0,0,0,0,0,0,2,1,0,1,1
H,0,1,0,0,0,1,0,0,0,0,0,0,0,0,0
I,2,0,0,0,1,0,0,0,1,0,0,0,0,0,0
K,0,1,1,0,0,0,2,0,0,0,2,0,0,0,0
L,2,0,0,1,2,1,0,0,0,0,1,0,0,0,0
M,0,0,0,0,0,0,1,0,0,0,1,0,1,0,0
N,0,0,0,0,0,1,0,0,0,0,0,0,0,1,0
P,0,0,1,0,0,0,0,0,0,0,0,0,1,0,1
Q,1,0,0,1,0,1,1,0,0,1,0,0,0,0,0
R,0,1,1,0,0,0,1,0,1,1,0,1,1,1,0
S,1,2,0,1,0,0,0,4,1,0,0,2,0,0,0
T,1,0,0,1,1,0,0,4,1,0,0,3,1,0,0
V,0,1,0,0,0,2,0,0,1,0,0,0,0,0,0
W,1,0,0,0,1,0,0,0,0,0,0,0,0,0,1
Y,0,0,1,1,0,0,0,0,0,0,0,0,2,0,1
