,0,1,2,3,4,5,6,7,8,9,10,11,12,13,14
A,2,1,0,1,2,0,0,0,2,0,1,0,0,1,1
C,0,0,0,0,0,1,0,0,0,2,0,0,0,0,0
D,1,0,4,4,2,1,3,0,0,2,2,0,0,1,2
E,2,1,3,0,0,2,2,0,0,0,0,3,2,1,1
F,0,0,0,0,0,0,0,0,1,1,0,0,2,0,0
G,0,2,1,0,1,0,4,0,1,0,2,0,1,0,4
H,0,1,0,0,0,1,0,0,0,0,0,1,0,0,0
I,0,0,1,0,0,0,0,0,0,0,0,2,0,0,0
K,2,4,1,0,3,0,2,0,0,1,0,0,0,1,0
L,2,2,2,4,3,2,1,0,4,2,1,0,1,0,0
M,0,0,0,0,0,0,0,0,1,0,0,0,1,0,0
N,0,0,0,0,1,0,0,0,0,0,1,0,0,0,0
P,0,0,0,0,0,0,0,0,0,0,0,1,0,0,1
Q,2,2,0,0,0,3,0,0,1,0,2,0,2,3,0
R,2,0,2,0,1,1,0,0,0,2,0,0,2,0,0
S,0,1,0,3,1,0,0,9,1,1,1,4,2,2,1
T,1,0,0,0,0,0,2,4,1,0,2,1,1,0,1
V,0,0,0,2,0,0,0,0,2,2,2,2,0,3,1
W,0,0,0,0,0,0,0,0,0,0,0,0,0,0,0
Y,0,0,0,0,0,3,0,1,0,1,0,0,0,2,2
