,0,1,2,3,4,5,6,7,8,9,10,11,12,13,14
A,2,0,1,0,1,1,1,0,1,6,2,1,4,1,2
C,1,1,0,0,1,0,1,0,0,0,0,0,2,0,0
D,0,2,3,0,0,0,2,0,0,1,2,0,0,2,1
E,0,1,1,4,1,0,1,0,2,1,0,0,2,0,2
F,0,0,1,0,3,0,0,0,2,0,1,0,0,0,2
G,3,3,2,0,0,2,3,0,1,0,2,1,1,1,1
H,0,0,0,1,1,0,0,0,1,0,0,0,0,1,0
I,2,1,1,0,1,1,1,0,0,0,0,1,1,0,1
K,1,2,1,1,2,1,3,0,0,0,3,0,0,2,0
L,2,0,0,1,4,1,3,0,3,0,2,2,3,2,1
M,0,0,1,1,2,1,2,0,0,0,0,1,2,0,1
N,2,1,4,0,1,0,1,0,0,1,0,1,0,1,0
P,0,0,2,1,1,1,1,0,2,1,1,1,0,2,2
Q,3,0,0,0,1,0,0,0,1,1,1,1,2,2,1
R,0,0,1,2,1,1,0,0,2,1,0,3,0,4,2
S,1,5,2,5,1,3,2,11,1,5,2,2,0,2,0
T,4,2,1,2,1,6,1,9,0,1,2,5,2,0,1
V,0,3,0,2,0,3,0,0,5,2,3,2,1,0,3
W,1,1,0,0,0,0,0,0,0,0,0,0,1,0,0
Y,0,0,1,2,0,1,0,2,1,2,1,1,1,2,2
