,0,1,2,3,4,5,6,7,8,9,10,11,12,13,14
A,1,0,0,0,0,1,0,0,0,4,0,0,1,0,3
C,0,0,0,1,0,0,0,0,0,1,0,1,0,0,0
D,2,1,1,3,0,0,4,0,0,0,0,2,0,3,1
E,1,1,1,2,0,0,0,0,0,2,3,1,1,0,0
F,0,0,0,0,0,0,1,0,1,0,0,0,1,0,0
G,1,4,4,1,0,0,0,0,0,1,2,1,0,0,4
H,0,0,0,0,0,0,0,0,1,0,0,0,1,0,1
I,2,3,0,1,2,1,0,0,0,0,0,4,1,0,1
K,0,1,2,1,3,2,6,0,0,1,4,0,0,2,1
L,4,0,3,0,3,0,1,0,7,1,0,1,3,2,0
M,0,0,0,0,1,0,0,0,1,0,0,0,1,0,0
N,0,1,0,0,0,0,1,0,0,0,1,1,0,2,0
P,0,0,1,1,1,0,1,0,2,3,0,0,2,1,0
Q,1,0,2,1,0,1,0,0,1,0,3,0,0,5,0
R,1,0,3,1,6,3,2,0,2,4,3,0,4,0,1
S,0,4,1,3,1,3,0,10,0,0,0,2,1,2,2
T,1,1,0,0,0,1,0,8,0,0,1,4,1,0,1
V,3,2,0,0,1,3,1,0,2,1,1,1,0,1,0
W,0,0,0,1,0,0,0,0,0,0,0,0,0,0,1
Y,1,0,0,2,0,3,1,0,1,0,0,0,1,0,2
