,0,1,2,3,4,5,6,7,8,9,10,11,12,13,14
A,3,0,5,0,1,1,0,0,0,4,1,1,1,0,1
C,0,0,0,0,1,0,0,0,0,0,0,0,0,0,0
D,0,5,1,3,0,0,1,0,0,0,0,0,0,1,0
E,0,0,1,4,1,3,0,0,0,0,0,1,1,1,1
F,0,0,0,0,0,0,0,0,0,0,0,0,0,0,0
G,0,1,1,1,2,0,5,0,3,0,0,0,0,0,0
H,0,1,0,0,0,0,0,0,0,0,0,0,0,0,0
I,2,0,0,0,0,0,0,0,1,0,0,0,1,1,1
K,2,0,1,0,0,1,0,0,0,0,1,0,0,0,0
L,1,0,2,0,2,0,1,0,0,0,0,0,0,0,0
M,0,0,0,0,4,0,3,0,1,1,0,1,0,0,0
N,0,0,0,0,0,0,0,0,0,0,0,0,0,0,1
P,0,0,0,1,0,0,2,0,1,0,1,1,1,1,0
Q,0,2,0,0,0,0,0,0,0,0,0,0,0,0,0
R,3,1,0,0,0,0,0,0,0,0,0,4,1,3,4
S,0,2,1,1,1,0,0,1,0,0,1,0,0,0,1
T,1,0,0,0,0,5,0,5,0,0,4,2,3,0,0
V,0,0,0,1,0,2,0,0,5,2,3,2,0,1,0
W,0,0,0,0,0,0,0,0,1,0,1,0,4,0,3
Y,0,0,0,1,0,0,0,6,0,5,0,0,0,4,0
