,0,1,2,3,4,5,6,7,8,9,10,11,12,13,14
A,5,0,3,0,1,2,0,0,0,3,3,1,0,0,2
C,0,1,0,0,0,0,0,0,0,0,0,0,1,0,0
D,1,4,2,2,0,0,2,0,1,1,0,1,0,1,0
E,0,1,1,4,1,3,0,0,1,1,0,0,0,0,0
F,0,0,2,1,3,0,0,0,0,0,0,0,0,0,0
G,2,2,1,0,1,0,5,0,2,0,0,1,0,1,0
H,0,1,0,0,0,0,0,0,0,2,0,0,0,0,0
I,1,0,1,0,1,0,0,0,1,0,1,0,0,0,0
K,0,0,0,1,0,0,1,0,0,0,1,1,0,1,0
L,1,0,1,1,1,0,0,0,0,1,0,0,1,0,1
M,0,0,0,2,6,2,4,0,0,0,0,0,1,0,0
N,0,1,0,1,0,0,0,0,0,0,1,1,0,0,1
P,0,0,1,0,1,1,3,0,3,0,0,0,0,0,1
Q,0,1,0,1,0,1,0,0,0,0,0,1,1,1,1
R,2,0,0,1,0,0,0,0,1,0,0,6,1,5,6
S,0,2,1,2,0,0,0,3,0,0,0,0,0,0,0
T,3,0,2,0,1,6,1,6,0,0,6,1,4,0,0
V,1,3,1,0,0,1,0,0,7,4,4,3,1,0,0
W,0,0,0,0,0,0,0,0,0,0,0,0,4,1,2
Y,0,0,0,0,0,0,0,7,0,4,0,0,2,6,2
